+---+---+---+---+---+---+---+---+---+---+---+---+---+---+---+---+
|                                                               |
+   +   +   +   +   +   +   +   +   +   +   +   +   +   +   +   +
|                                                               |
+   +   +   +   +   +   +   +   +   +   +   +   +---+---+---+---+
|                                                       |       |
+   +   +   +   +   +   +   +   +   +   +   +   +   +   +   +   +
|                                                       |       |
+   +   +   +   +   +   +   +   +   +   +   +   +   +   +   +   +
|                                                       |       |
+   +   +   +   +   +   +   +   +   +   +   +   +   +   +   +   +
|                                                       |       |
+   +   +   +   +   +   +   +   +   +   +   +   +   +   +   +   +
|                                                       |       |
+   +   +   +   +   +   +   +   +   +   +   +   +   +   +   +   +
|                                                       |       |
+   +   +   +   +   +   +   +   +   +   +   +   +   +   +   +   +
|                                                       |       |
+   +   +   +   +   +   +   +   +   +   +   +   +   +   +   +   +
|                                                       |       |
+   +   +   +   +   +   +   +   +   +   +   +   +---+---+   +   +
|                                           |                   |
+   +   +   +   +   +   +   +   +   +   +   +   +   +   +   +   +
|                                           |                   |
+   +   +   +   +   +   +---+---+---+---+---+---+---+---+---+   +
|                       |               |                       |
+   +   +   +   +   +   +   +   +   +   +   +   +   +   +   +   +
|                       |               |       |               |
+---+---+---+---+---+---+   +   +   +   +---+---+   +   +   +   +
|                                                               |
+   +   +   +   +   +   +   +   +   +   +   +   +   +   +   +   +
|                                                               |
+---+---+---+---+---+---+---+---+---+---+---+---+---+---+---+---+
