+---+---+---+---+---+---+---+---+---+---+---+---+---+---+---+---+
|                                                               |
+   +   +   +   +   +   +   +   +   +   +   +   +   +   +   +   +
|                                                               |
+   +   +   +   +   +   +   +   +   +   +   +   +   +   +   +   +
|                                                               |
+   +   +   +   +   +   +   +   +   +   +   +   +   +   +   +   +
|                                                               |
+   +   +   +   +   +   +   +   +   +   +   +   +   +   +   +   +
|                                                               |
+   +   +   +   +   +   +   +   +   +   +   +   +   +   +   +   +
|                                                               |
+   +   +   +   +   +   +   +   +   +   +   +   +   +   +   +   +
|                                                               |
+   +   +   +   +   +   +   +   +   +   +   +   +   +   +   +   +
|                               |                               |
+   +   +   +   +   +   +   +---+   +   +   +   +   +   +   +   +
|                           |       |                           |
+   +   +   +   +   +   +---+   +---+   +   +   +   +   +   +   +
|                       |       |                               |
+   +   +   +   +   +---+   +---+   +   +   +   +   +   +   +   +
|                   |       |                                   |
+   +   +   +   +---+   +---+   +   +   +   +   +   +   +   +   +
|               |       |                                       |
+   +   +   +---+   +---+   +   +   +   +   +   +   +   +   +   +
|           |       |                                           |
+   +   +---+   +---+   +   +   +   +   +   +   +   +   +   +   +
|       |       |                                               |
+   +---+   +---+   +   +   +   +   +   +   +   +   +   +   +   +
|   |       |                                                   |
+---+   +---+   +   +   +   +   +   +   +   +   +   +   +   +   +
|                                                               |
+---+---+---+---+---+---+---+---+---+---+---+---+---+---+---+---+
