+---+---+---+---+---+---+
|                       |
+   +   +---+---+---+   +
|   |                   |
+   +   +---+---+   +---+
|   |   |               |
+   +---+   +   +   +   +
|       |               |
+---+   +   +   +   +   +
|       |               |
+   +   +   +   +   +   +
|   |                   |
+---+---+---+---+---+---+
